#Nowhere

MAZE:"nowhere",random
FLAGS: noteleport,nommap

INIT_MAP: ' ' , ' ' , false , false , unlit , false

GEOMETRY:center,center
#0         1         2   	   3	     4	       5		 6	       7
#0123456789012345678901234567890123456789012345678901234567890123456789012345
MAP
0                                                                            
1                                                                            
2                                                                            
3                                                                            
4                                                                            
5                                                                            
6                                                                            
7                       AA                                                   
8                       AA                                                   
9                                                                            
0                                                                            
1                                                                            
2                                                                            
3                                                                            
4                                                                            
5                                                                            
6                                                                            
7                                                                            
8                                                                            
9                                                                            
0                                                                            
ENDMAP
#0123456789012345678901234567890123456789012345678901234567890123456789012345
#0         1         2   	   3	     4	       5		 6	       7

# Non diggable walls
NON_DIGGABLE:(00,00,75,20)
