MAZE: "sacris", ' '
FLAGS: noteleport,hardfloor,nommap
GEOMETRY: center, center
MAP
 ------- 
 |.|.|.| 
--.....--
|..-|-..|
|-..-...|
|..-|-..|
--.....--
 |.|.|.| 
 ------- 
ENDMAP
BRANCH: (05,04,05,04),(0,0,0,0)
ALTAR:(03,04),noalign,altar,"an alien god"
MONSTER:'U',"Unknown God", (02,04), peaceful
